PKGYVGAEFPLDITAGTEAA	AEFPLDIT
RSKYGWTAFCGPVGAHGQSS	AFCGPV
PGPQGLAGQRGIVGLPGQRG	AGQRGIV
PGPQGLAGQRGIVGLPGQRG	LAGQRGIV
VSATHAKSSPYQKKTENPCA	AKSSPYQKKT
YIETSAKTRQGVEDAFYTLV	AKTRQGVEDA
PGLLRSDALEAYAYTGEGVT	ALEAYA
THQKAFIARGLTEALTRVIA	ARGLT
EPGLPGARGLTGRPGDAGPQ	ARGLT
EPGLPGARGLTGRPGDAGPQ	ARGLTGRP
EPGLPGARGLTGRPGDAGPQ	ARGLTGRPGDA
RFELTNEASDLMYHLLVLLQ	ASDLM
RFVNASPTGYDWRADWVKGF	ASPTGYDWRADW
RFVNASPTGYDWRADWVKGF	YDWRADW
SLGASPYPNLSNQQTREFVE	ASPYPNLSNQQTR
IHSSCNATQRRQIEAGLNEA	ATQRRQI
VVAVLAYNDAYVMSAWGKAN	AVLAYNDAYVMSAWGK
AVQAFILTGGKSKQTEGLLL	AVQAFILTGGKSKQTEGLLL
FGKADCDRPPKHSQNGMGKD	CDRPPKHSQN
CGIPINYNASKEWADKKVIL	CGIPINYNASKEWADKKVIL
NRFLVGCHPSDGKCNLYADS	CHPSDGKC
VEQMCITQYQRESQAYYQRG	CITQYQRESQAYY
GFDLVLLGCSTWGDDSIELQ	CSTW
CSVTCGVGVRVRRRVNAANK	CSVTCGVGVRVRRRVNAANK
CQCWRKDPEERPTFKYLQAQ	CWRKDPEERPTFKYL
CQCWRKDPEERPTFKYLQAQ	RKDPEER
NCYKKVWRDHRGTIIERGCG	CYKKVWRDHRGTIIERGC
QPGDRADGQPAGDRADGQPA	DGQPAGDRA
QPGDRADGQPAGDRADGQPA	GDRADGQPAGDRADGQPA
NLLLAWLEDHFADEVNWDAV	DHFAD
DLDANGILNVSAEEKGTGKR	DLDANGILNVSAEEKGTGKR
KCDLPSRTVDTKQAQELARS	DLPSRTVDTKQAQELAR
ADNTRTSGDNAPVSCLGEHH	DNTRTSGDNAPVSCLGE
WQGDPIPEELYKMLSGHSIR	DPIPEELYKMLSGHS
TTPTAADTPTATESISPSPP	DTPTATE
RDHGLPATDVYAMAQVEGAG	DVYA
IHFGNDYEDRYYRENMYRYP	DYEDRYYRE
SEAARCIDGAFTPKNRTAAD	EAARCIDGAFTPKNRTAAD
VNDAMKYEADDRAQRDRVEA	EADDRA
LEYTEDEVVSSDFVGSTSSS	EDEVVSSDFVG
FEDIHQYREQIKRVKDSDDV	EDIHQYREQIKRVKDSDD
LARLIEDNEYTARQGAKFPI	EDNEYTARQG
LARLIEDNEYTARQGAKFPI	RLIEDNE
LARLIEDNEYTARQGAKFPI	RLIEDNEYTARQGAKFP
EEDSGSNGKKITCECTKPDS	EDSGSNGKKITCECTKPDS
AAAKKEEEEEDDDMGFGLFD	EEEDDDMGFGLFD
NVEHDAEENVEHDAEENVEE	EENVEHDAEENVEHDAEENVEENV
NVEEVIDTMKSMQRDEDIFL	EEVIDTMKSMQRDED
EGLLLLDVTPLTLGIETAGG	EGLLLLDVTPLTLGIETAGG
ELDGQEYVVEFDFLGKDSIR	ELDGQEYVVEFDFLGKDSIR
PNRNVDENANANNAVKNNNN	ENANANNAV
VGHFENVVGADKSSILFLCD	ENVVGADKSSIL
ALEPAKNHLEFSSAETVLKH	EPAKNHLEFSSAETVL
LIAEKEQLRRRREQLKHNLE	EQLRRRREQLK
LIAEKEQLRRRREQLKHNLE	RREQLKH
THNVLERQRRNELKLRFFAL	ERQRRNELKLR
ETAGGVMTALIKRNTTIPTK	ETAGGVMTALIKRNTTIPTK
NKTEEVCVRQLKAIANKIKS	EVCVRQLKAIANK
FFTEEFKRKNKGKNLASSHR	FFTEEFKRKNKGKNLASSHR
LTFLRTEGARLRMKTLLQMV	FLRTEGARLRMKTLL
HYLLEFPTFPDGHDYKFDSK	FPTFPDGHDY
NSSSSQFQIHGPRQWSKLVS	FQIHGPR
YKLVVVGAGGVGKSALTIQL	GAGGVGKS
AGKEGAIIFQQVMSRSANEG	GAIIFQQVMSRS
GDAKKKKDGKKAEPKNPREN	GDAKKKKDGKKAEPKNPREN
QRSPPGERTRGRQPGDYDDD	GERTRGRQPG
NKVFCGIVAHQRGNQGDLRL	GIVAHQRGNQ
SQNGMGKDDHYLLEFPTFPD	GKDDHYLLEF
GLFHKEKMILNEEEITTKGA	GLFHKEKMILNEEEITTKGA
KGNAEKYDKMDEPQHYGKSN	GNAEKYDKMDEPQHYGKS
PENKGTGQHGHMHGSRNNHP	GQHGHMHG
EEGRTKRYALVIDHGKITYA	GRTKRYALVIDHGKIT
IPGRVSTEVDARLSFDKDAM	GRVSTEVDARLSFDK
SRPLIHFGSDYEDRYYRENM	DYEDRYYRE
SRPLIHFGSDYEDRYYRENM	GSDYEDR
GWCGSTDEYCSPDHNCQSNC	GSTDEYCSPDHNC
VNIVGYSNAQGVDYWIVRNS	GYSNAQGVDYWI
KRLFKESQHRGFTIRQSRRI	HRGFT
KRLFKESQHRGFTIRQSRRI	RLF
RGSNHSDQTIICDLSFVTRR	HSDQTIICDLSF
HSGVVPNISKAMAKKKGGKK	HSGVVPNISKAMAKKKGGKK
SATTDANSHCHTHADGEVHC	HTHADGEVH
VEVVLADPNHWRFQGGKWVT	HWR
IAYGLDKGDDGKERNVLIFD	IAYGLDKGDDGKERNVLIFD
IQRHYTDEDPEKEKRIKELE	IQRHYTDEDPEKEKRIKEL
IQRHYTDEDPEKEKRIKELE	YTDEDPEKEKRIKE
ASGQEAAAIRRAVGSGFSIV	IRRA
SQVRLLWKDPRNVGWKDKTS	KDPRNVG
ISKAMAKKKGGKKGKATPSA	KGGKKGKATPSA
LLTELTTKGRVPYPGMGNGE	KGRVPY
LRKRREQLKHKLEQLRNSCA	KHKLEQLRNSCA
LRKRREQLKHKLEQLRNSCA	RREQLKH
KHRKFKHTHDKTALKETLGA	KHTHDKTALKETLGA
GDYVWKISEFYGRKPEGTYY	KISEFYGRKP
TETDLSFKKGERLQIVNNTE	KKGERL
QEAQVMKKLRHEKLVQLYAV	KKLRHEK
KLRKPKHKKLKQPGDGNPDP	KPKHKKLKQPGDGNP
MKPQEEKEKITKEILNGKVP	KPQEEKEKITKEILNGK
QGEGLKYLGFVQDAATYAVT	KYLGFVQDAA
LNHLKSEMEQRLRERDEELE	LNHLKSEMEQRLRERDEELE
LNKSINPDEAVAYGAAVQAF	LNKSINPDEAVAYGAAVQAF
DKSGPLQPGVDIIEGPVKNV	LQPGVDIIEG
QPDEGVTLRFGSKVPGTAME	LRFGSK
SHLMAFAHNPPAGPLPGAGQ	MAFAHNPPAGPLPGA
MATPRSAKKAARKSGSKSAK	MATPRSAKKAARKSGSKSAK
LQGMPGERGAAGIAGPKGDR	MPGERGAAGIAGPK
IKKMQTLWDEIMDINKRKYD	MQTLWDEIMDINKRK
AMTEYKLVVVGARGVGKSAL	MTEYKLVVVGARGVGKSA
MTKDCHLLGTFDLSGIPPAP	MTKDCHLLGTFDLSGIPPAP
QIAANAGKEGAIIFQQVMSR	NAGKEGAIIFQQ
NVNPNANPNANPNANPNANP	NANPNANPNANP
NVNPNANPNANPNANPNANP	NANPNANPNANPNANP
LDDKCKNDGWAGYWRGSNHS	NDGWAGYW
VNEREDERTLTKEYEDIVLK	NEREDERTLTKEYEDIVLK
QIPELENNEKAPKVVILKKA	NNEKAPKVV
VGLFGNNENQTKVSNGAFVP	NNENQTKVSN
NQPGVHIQVFEGERAMTKDC	NQPGVHIQVFEGERAMTKDC
PNLSNQQTREFVEKGGRLPC	NQQTREFVEKGGR
MVNREVLDQVERGYRMPCPP	NREVLDQVERGYRMP
QNSGCFRHLDEREECKCLLN	NSGCFRHLDEREECKCLL
KQPGNDNVDPNANPNVDPNA	NVDPNANP
GHITVNYQFVDCGDSFNPLF	NYQFVDCGD
LFLSDPDARFSKSIGWADEE	PDARFSKSIGW
PLQLVPEVQKPLHEQLWYHG	PEVQKPLHEQ
VTTPFHKDQTFTEYRKMHGG	PFHKDQTFTEYRKM
QGHNMPNDPNRNVDENANAN	PNDPNRNVD
EETPPTTSSDSEEEQEDEEI	PPTTSSDSEEEQE
PSPPVDHGCLPEESASPARC	PPVDHGCLPEESASPA
PSPPVDHGCLPEESASPARC	PSPPVDHGCLPEESASPAR
DSSAHSTPSTPADSSAHSTP	PSTPAD
DSSAHSTPSTPADSSAHSTP	STPSTP
DSSAHSTPSTPADSSAHSTP	TPADSS
DSSAHSTPSTPADSSAHSTP	TPSTPA
QDENPVVHFFKNIVTPRTPP	PVVHFFKNIVTP
TWDANKPYSWRSKYGWTAFC	PYSWRSK
TWDANKPYSWRSKYGWTAFC	PYSWRSKYGW
TWDANKPYSWRSKYGWTAFC	WDANK
RASAEHSQASTSSFPYYHIA	QASTSS
CNATQYNQLSTGLQEAQLLA	QYNQLSTGLQEA
RARFEELCGDLFRSTIQPVE	RARFEELCGDLFRSTIQPVE
NEYTAREGAKFPIKWTAPEA	REGAKFPIK
LVREIRQYRLKKISKEEKTP	REIRQYRLKKISKEE
PKGARGAQGPPGATGFPGAA	RGAQGPPGATGF
DDRHSTSSSEQEREGGRTPT	RHSTSSSEQEREGGR
RIANFKIEPPGLFRGRGNHP	RIANFKIEPPGLFRGRGNHP
RKFNDSVVQSDMKHWPFKVT	RKFNDSVVQSDMKHWPFKVT
VRKIEIVRKKPIFKKATVTL	RKIEIVRKKPIFKKATV
HMIQKTRKRKYFHHNQLDWD	RKYF
LTVVPPVRKYFGDVNPAPIP	RKYF
LTVVPPVRKYFGDVNPAPIP	RKYFG
VRLVPGDARLFKVTTPGDLA	RLF
VADFGLARLIEDNEYTARQG	EDNEYTARQG
VADFGLARLIEDNEYTARQG	RLIEDNE
RLKKISKEEKTPGCVKIKKC	RLKKISKEEKTPGCVKIKK
WYFGKITRRESERLLLNPEN	RRESER
MRRKVEQEGYPQESSKAGPP	RRKVEQEGYPQESSKAGP
SNREVRRYTARLKEGDVFIM	RRYTARLKEG
CSSPRTLDSEENDKRRTHNV	RTLDSEENDKRR
LKALSAPLKQIAANAGKEGA	SAPLKQIAANAG
FGAMGVPGSAYCQPITTVTA	SAYC
SFEDSDSGSDSGASSTASSS	SDSGSDSGASST
FGILLWETFSLGASPYPNLS	SDVWSFGILLWETFSLGASPYPNLSNQQTR
SGGAGPAGGASSGPKVEEVD	SGGAGPAGGASSGPKVEEVD
DKKISGIKDFLPVLQQVAES	SGIKDFLPVLQQ
GPLKGILEYTEDEVVSSDFV	SGPLKGILEYTEDEVVSSDFVG
TASSSHQHTDSNPSATTDAN	SHQHTDSNPSAT
RSLGSLSVAEPAMIAECKTR	SLGSLSVAEPAMIAECKT
KNESKYSNTFINNAYNMSIR	SNTFINNA
CPNNLCCSQWGWCGSTDEYC	SQWGWC
KISDFGMSREAADGIYAASG	SREAADG
KSDFSSFEDSDSGSDSGASS	SSFEDSDSGSDS
HSTTVADNTRTSGDNAPVSC	STTVADNTRTSGDNAPV
FGNDTASAEVVGHFENVVGA	TASAEVVGHFEN
ATIDVPSNCHTHEGGQLHCT	THEGGQ
NACSINGNAPAEIDLRQMRT	TNACSINGNAPAEIDLRQMRT
PNSEDRETRPHGRNNENRSY	TRPHGR
DDITYVATATLPNYCRAGGN	VATATLPNYC
AFTPVCSARHVPEYIEKLPE	VCSARHVPEYI
HFVDEYDPTIEDSYRKQVVI	VDEYDPTIEDSYRKQV
FPSDVVFSYIPWSEDKGEIT	VFSYIPWSEDK
PGPARVIYTYPNKVFCGIIA	VIYTYPNKVF
VLIFDLGGGTFDVTLLTIDG	VLIFDLGGGTFDVTLLTIDG
AKLVPVLSAKAAQASDLEKI	VPVLSAKAAQASDLE
VQYRGEEKTFTPEEISSMVL	VQYRGEEKTFTPEEISSMVL
VREIRQHKLRKLNPPDESGP	VREIRQHKLRKLNPPDESGP
YWIVRNSWDTNWGDNGYGYF	VRNSWDTNWGDNGY
VRRRVNAANKKPEDLTLNDL	VRRRVNAANKKPEDLTLNDL
VTHESYQELVKKLEALEDAV	VTHESYQELVKKLEALEDAV
EAVKVTLGPKGRHVVIDKSF	VTLGPKGRHVVI
PTKQPAVVYPWMKKVHVTTV	VVYPWMKK
PTKQPAVVYPWMKKVHVTTV	VYPWMK
YALDVYAYDVTIPGEGCNGD	DVYA
YALDVYAYDVTIPGEGCNGD	VYAYDVTIPGEG
TLSKEPIVYPWMKKIHVTTV	VYPWMK
GKYEGLKIWDANKVIVEDLK	WDANK
WGEEKRASHTTPVLMEKPYY	WGEEKRASHTTPVLMEKPYY
TFWSWNPDSGDTGGILKDDW	WNPDSGDTGGI
LMCQCWRRDPEERPTFEYLQ	WRRDPEERPT
SITEEWSPCSVTCGSGIRAR	WSPCSVTCG
WWEEERYPEGIKWKFLEHKG	WWEEERYPEGIKWKFLEHKG
EKLVQLYAVVSEEPIYIVTE	YAVVSEEP
SPTGYDWRADWVKGFPIDSS	YDWRADW
SPTGYDWRADWVKGFPIDSS	YDWRADWVKGFP
LSYPIGGNYHVPHGEANYLF	YHVP
MFLQIYKQGGFLGLSNIKFR	YKQGGFLGL
REQIKRVKDSDDVPMVLVGN	YREQIKRVKDSDDVPMVLVGNKC
EDHKWYSCGENSFMDFSFDS	YSCGENSFMD
ITRPGGNMYTTRRYAACIRD	YTTRR
VVTPVYYIPLEAVKFVDKTV	YYIPLEAVKF
KPEGTYYNSLGFNIKATNGG	YYNSLGFNIK
YPNQVYYRPVDQYSNQNNFV	YYRPVDQYS
CAVVYPWMKKVHVNSVNPNY	CAVVYPWMKKVHVNSVNPNY
CAVVYPWMKKVHVNSVNPNY	VVYPWMKK
CAVVYPWMKKVHVNSVNPNY	VYPWMK
ELFNELLNSVDVNGENILEE	DELFNELLNSVDVNGENILEESQ
NCDWDPYHEKYDWDLWNKWC	DPYNCDWDPYHEKYDWDLWNKWCNK
INEDDKSAHIQHEIVEVEEI	EFKEINEDDKSAHIQHEIVEVEEILPEDD
PENVETEEIIDDVPSPKHSN	EIILPENVETEEIIDDVPSPKHSNHETF
EKSELILRDGGVGMTKEELA	EKSELILRDGGVGMTKEELA
EPLTKDGEAPTMDLRISFDK	EPLTKDGEAPTMDLRISFDK
ASQHGCHGDTIPRGIEYIQH	EQELVDCASQHGCHGDTIPRGIEYIQHNGVVQESY
EQYVWESKGDGQYFLYPDPR	EQYVWESKGDGQYFLYPDPR
FADKPDESTLSPEMKEHYEK	FADKPDESTLSPEMKEHYEK
GAYVEVKFSQYGDNLHKVWQ	GAGAYVEVKFSQYGDNLHKVWQAAC
GFGLKVWEVRREKEELKRDK	GFGLKVWEVRREKEELKRDK
GVGAGGGDQNNLIGQFGVGF	GVGAGGGDQNNLIGQFGVGF
IPPAPRGLPQIEVTFDLDAN	IPPAPRGLPQIEVTFDLDAN
ISNGSDALDKIRVLYLTSPK	ISNGSDALDKIRVLYLTSPK
KHLGSLGTSGTKHFLEKLQE	KHLGSLGTSGTKHFLEKLQE
SQVNDDIFNSLVKSVQQEQQ	LEESQVNDDIFNSLVKSVQQEQQHNV
LESVCNPIMTKMYQSMGGAA	LESVCNPIMTKMYQSMGGAA
LVRKTLSMFADIAAQDEAIA	LVRKTLSMFADIAAQDEAIA
MANSSLLRVVLVALLLLGSV	MANSSLLRVVLVALLLLGSV
MATTEYRLSLMEQFIRAFIE	MATTEYRLSLMEQFIRAFIE
MGGAAGGMPGGMPGMSGMSG	MGGAAGGMPGGMPGMSGMSG
MLDILVNSLYTNRAVFLREL	MLDILVNSLYTNRAVFLREL
MTFEGAIGIDLGTTYSCVGV	MTFEGAIGIDLGTTYSCVGV
EKKTNEKKDDGKTDKVQEKV	NGKDDVKEEKKTNEKKDDGKTDKVQEKVLEKSPKEF
EEKKTNEKKDDGKTDQEKVL	NGKDDVKEEKKTNEKKDDGKTDQEKVLEKSPKEF
NGKQVESPAPSGHTHLKKPA	NGKQVESPAPSGHTHLKKPA
NNRNRLTKLFRYKSSRSESE	NNRNRLTKLFRYKSSRSESE
PFKVTTKGADKPVISVQYRG	PFKVTTKGADKPVISVQYRG
PGHKWKEVRHDNKVTWLVSW	PGHKWKEVRHDNKVTWLVSW
DSQPNPQEPVEPSFVKIEKV	PNFVDSQPNPQEPVEPSFVKIEKVPSEEN
KKDEKEASEQGEESHKKENS	SAEKKDEKEASEQGEESHKKENSQESA
SDARQRVADRKRKEKYDSFF	SDARQRVADRKRKEKYDSFF
SFHCCGAKGPDDYRGNVPAS	SSFHCCGAKGPDDYRGNVPASCK
TAADGYYAGLCANVRCDTAT	TAADGYYAGLCANVRCDTAT
APSVEESVAPSVEESVAENV	VESVAPSVEESVAPSVEESVAENVEESV
WIARFDTDKDGKVSLEEFCR	WIARFDTDKDGKVSLEEFCR
YLGRSGGDIIKKMQTLWDEI	YLGRSGGDIIKKMQTLWDEIM
YSVFLVGDRVRVASKSDDSD	YSVFLVGDRVRVASKSDDSD
