KLGAAASSPDAHVPFCFGKD	AAASSPDAHVPFCF
ADNATAEGRAINRRVEAEVE	AEGRAINRRVE
ADNATAEGRAINRRVEAEVE	DNATAEGRAINRRVE
ADNATAEGRAINRRVEAEVE	NATAEGRAINRRVE
AISALPDYASQPGKPPREDL	ALPDYASQPGKPPR
LANDVDNSNPVVQAEQLNWL	ANDVDNSNPVVQAEQLNWL
RQPEAPAPQPPAGRELSAAA	APQPPAGR
ALENAASIAGMFLTTECVIA	ASIAGMFLTT
LQRATIRRGDAPAGGAVPGG	ATIRRGDAPAGGAVP
SEYNFAVNELSKSSFNQAAI	AVNELSKSSFN
GFTAGVKAVNPNAQIDVQYA	AVNPNA
CHHLDKSIKEDVQFADSRIR	CHHLDKSIKEDVQFADSRI
PKDTQYDIGFTESTLLDGSG	DIGFTESTL
APGFGDRRKAMLQDIATLTG	DRRKAMLQD
PALADVPYVLVKTNMVVTSV	DVPYVLVKTNMV
PALADVPYVLVKTNMVVTSV	PYVLVKTNMVVT
PALADVPYVLVKTNMVVTSV	VLVKTNMVVTSV
APVQEGVQQEGAQQPAPATA	EGVQQEGAQQPA
MTEQQWNFAGIEAAASAIQG	EQQWNFAGIEAAA
SRSVFHQNGQVTEVTTATGI	FHQNGQVTEVTT
SRSVFHQNGQVTEVTTATGI	SVFHQNGQVTEVTT
TGADIKFKDGQYYLDVKGGA	FKDGQYYL
PLRMFLGPKQLTFEGKPALE	FLGPKQLTFEGK
ADHNTFGSVIPATGPLFTGT	FLLDADHNTFGSVIPATGPLFTGTASS
FTNTSGFANKTQDVLLVAQY	FTNTSGFANKTQDVLLVAQY
GAFDLKTTFCIMTTRNTGQP	GAFDLKTTFCIMTTRNTGQPA
IRRGDAPAGGAVPGGAVPGG	GDAPAGGAVPGGAVP
GDLVGPGCAEYAAANPTGPA	GDLVGPGCAEYAAANPTGPA
APAGGAVPGGAVPGGAVPGG	GGAVPGGAVPGGAVP
AVPGGAVPGGFGPGGFGPVL	GGAVPGGFGPGGFGP
AVPGGAVPGGFGPGGFGPVL	GGFGP
AVPGGAVPGGFGPGGFGPVL	GGFGPGGFGP
VPGGAVPGGFGPLLDGWYGV	GGFGP
GGFGPGGFGPVLDGWYGVDV	GGFGP
GGFGPGGFGPVLDGWYGVDV	GGFGPGGFGP
GGFGPGGFGPVLDGWYGVDV	GGFGPGGFGPVLDGW
GGFGPGGFGPVLDGWYGVDV	GGFGPVLDGW
GGFGPGGFGPVLDGWYGVDV	GGFGPVLDGWYGVDV
SSSGISTNTSGSRSFLPTFS	GISTNTSGSRSFLP
FEGKPALELIRMVECSGKQD	GKPALELIRMVECSGK
VCGIAAKLGAAASSPDAHVP	IAAKLGAAASSPDA
TASVDPVIDLLQADGNALPS	IDLLQ
KTAAESAILEGKEIVSSATP	ILEGKE
GRLETILGWPLAERTVVIPS	ILGWPLAERT
NPFILIYDKKISVLKEMLPI	IYDKKISVLK
ENAKATYEAALKQYEADLAA	KATYEAALKQYEADL
ENAKATYEAALKQYEADLAA	NAKATYEAALKQYEADLAA
ENAKATYEAALKQYEADLAA	TYEAALKQYEADL
ENAKATYEAALKQYEADLAA	TYEAALKQYEADLAA
ASRKGLRRDLDASREAKKQV	KGLRRDLDASREAK
KNMSTYVDYIINQIDSDNKL	KNMSTYVDYIINQIDSDNKL
ITKTPTAWKPNYAPANCPKS	KPNYAPANCPKS
ITKTPTAWKPNYAPANCPKS	TAWKPNYAPANCPKS
ITKTPTAWKPNYAPANCPKS	TPTAWKPNYAPANCPKS
RNVGGDLDPSSIPDKEQAIS	LDPSSIPD
VSEVSALKTAAESAILEGKE	ILEGKE
VSEVSALKTAAESAILEGKE	LKTAAESA
LPEFGGDTAYSDDFFVGRVG	LPEFGGDTAYSDDFFVGRVG
LYMIYMSGLAVRVHVSKEEQ	LRRLLYMIYMSGLAVRVHVSKEEQYYDY
EALATLVVNRLRGSLKICAV	LVVNRLRGSL
ANFEYLIPANADPVVTTQNI	LYSANFEYLIPANADPVVTTQNIIVTG
SVAMKPYEVTPTRMLVCGIA	MKPYEVTPTRMLVCG
EVVEGMQFDRGYISPYMVTD	MQFDRGYISP
VLVNEYGVEGGRVNAVGYGE	NEYGVEGGRVNAVG
AAPALDKLKLTGDEATGANI	PALDKLKLTGDEATGA
GLETRGNPGPQPPAKNMKNL	PGPQPP
PGSSPMEVMLRAVFMQQRPL	PMEVMLRAVFMQ
GVVPQWGGGGNHNGGGNSSG	PQWGGGGNHNGGGN
PTNAAFSKLPASTIDELKTN	PTNAAFSKLPASTIDELKTN
LANSVKELTSPVVAESPKKP	PVVAESPKKP
KLQERLAKLAGGVAVLYVGA	QERLAKLAGGVAVLY
VGDDFQKIEHVAKISANGDE	QKIEHVAKIS
AIASYRRAAIRASLIPTVNQ	RAAIRAS
FDMESRDLLKKGVDALANAV	RDLLKKGVDA
LETFTRHRQPRGWEQLEQCG	RHRQPRGWEQ
FTFEAGKKYTFTMRRAGMGD	RYDDFTFEAGKKYTFTMRRAGMGDGTD
KQTQSSSETQKSQNYQQIAA	SETQKSQNY
FDYGRNYGVVYDALGYTDML	SFDYGRNYGVVYDALGYTDML
NKMVDSKDVKIEVYLTTKKK	SKDVKIEVYL
DLDASREAKKQVEKALEEAN	SREAKKQVEKAL
SVQGMSQDPVAVAASNNPEL	SVQGMSQDPVAVAASNNPEL
SVGTDAYNQKLSERRANAVR	TDAYNQKLSERRAN
NEDETTGIEIVKRAIEEPLR	TGIEIVKRAI
AEYAINNNWTLKSEYLYTDL	TKAGWTLGAGAEYAINNNWTLKSEYLYTDLGKRNLVDVDN
KPAYYTKDTNNNLTLVPAVV	TKDTNNNLTL
LSEMSHTLTPENTLDISSLS	TLTPENTL
GLASTLWYAESNALSKRLGE	TLWYAESNALSKR
PGIVIPPKALFTQQGGAYGR	VAPGIVIPPKALFTQQGGAYGRC
LRAVFMQQRPLRMFLGPKQL	VFMQQRPLRMFLGP
LYTTGVIDPAKVTRVALENA	VIDPAKVTRV
MGAQMVKEVASKTNDVAGDG	VKEVASKTND
PYVLVKTNMVVTSVAMKPYE	PYVLVKTNMVVT
PYVLVKTNMVVTSVAMKPYE	VKTNMVVTSVAM
PYVLVKTNMVVTSVAMKPYE	VLVKTNMVVTSV
GALLRVYVPRSSLPGFYRTG	VYVPRSSLPG
APNYEKEPTPPTRTPDQAEP	YEKEPTPPTRTPDQ
YTKSKAKDVEGIGDVDLVNY	YTKSKAKDVEGIGDVDLVNY
AVTRGTINDPQRAKEALDYE	AVTRGTINDPQRAKEALDYE
DANFDSIRVDAVDVNDALLQ	DANFDSIRVDAVDVNDALLQ
NGKAIYERARERALQELGPC	DNGKAIYERARERALQELGPC
FKGETQINSDLTGYGQWEYN	FKGETQINSDLTGYGQWEYN
YVKQEVEQNPPAAQKVFKDE	KYVKQEVEQNPPAAQKVFKDEK
FKHPFSSFDKEDGEHVSGSP	NAGYAGGKFKHPFSSFDKEDGEHVSGSPDVTAGGFV
VQVKDQQGEVVREYEVEKLG	SKNVPVQVKDQQGEVVREYEVEKLGNNVHV
AGDPALAYGYAQDQEPDAGY	YIAGDPALAYGYAQDQEPDAGYA
